Jeremy Abbott	jeremyabbottpcf
Nick Alexander	skiflyzander
Eddy Alvarez	eddyalvarez90
Jamie Anderson	Jme_Anderson
Matt Antoine	MattAntoine
David Backes	dbackes42
Lowell Bailey	Lowellcbailey
Nathan Bartholomay	NateBartholomay
Evan Bates	Evan_Bates
Nick Baumgartner	nickbaumgartner
Kacey Bellamy	kbells22
Erik Bjornsen	erikbjornsen
Sadie Bjornsen	sadzarue
Aaron Blunck	Aaron_Blunck
Mac Bohonnon	macbohonnon
Brittany Bowe	BrittanyBowe
Maddie Bowman	MaddieBowman
Megan Bozek	meganebozek
Greg Bretz	gregbretzz
Summer Britcher	summerbritcher
Holly Brooks	brooksha1
Bobby Brown	Bobby_Brown1
Jason Brown	jasonbskates
Dustin Brown	DustinBrown23
Erika Brown	ebrowncurls
Tim Burke	tb_burke
Cory Butner	corybutner
Ashley Caldwell	AshleySkis
Sophie Caldwell	dophed
Ryan Callahan	RyanCallahan24
John Carlson	JohnCarlson74
Alex Carpenter	carpy05
Kyle Carr	cKyleCarr
Marissa Castelli	marissacastelli
J.R. Celski	jrcelski
Madison Chock	chockolate02
Lauren Cholewinski	LMCholewinski
Joss Christensen	josschristensen
Julie Chu	juliechu13
Kelly Clark	Kellyclarkfdn
Stacey Cook	staceycookusa
Emily Cook	emilycook
Kendall Coyne	KendallCoyne
Chris Creveling	TophCrev
Nick Cunningham	BOBSLEDR
Lyman Currier	urmotherlovesme
Russell Currier	RussellCurrier
John Daly	JohnDalyUSA
Shani Davis	ShaniDavis
Meryl Davis	Meryl_Davis
Danny Davis	theddeadshow
Brianna Decker	Bdecker14
Alex Deibold	adeibold
Billy Demong	BillyDemong
Patrick Deneen	patrick_deneen
Jessie Diggins	jessdiggs
Annalisa Drew	ANNA_DREW_
Alyson Dudek	alydudek
Meghan Duggan	mduggan10
Susan Dunklee	SusanDunklee
Polina Edmunds	PolinaEdmunds
Aja Evans	AjaLEvans
Nick Fairall	Nick_Fairall
Kaitlyn Farrington	kaitlynfarr
Justin Faulk	JustinFaulk27
Jazmine Fenlator	JazmineFenlator
Erik Fisher	skifastfish
Bryan Fletcher	SkiFletch
Taylor Fletcher	Tfletchernordic
Chris Fogt	christopherfogt
Julia Ford	Juliawford
Cam Fowler	C_Fowler4
Tucker Fredericks	TuckerFredricks
Kris Freeman	teamfreebirdxc
Peter Frenette	pfskijumping
Lyndsey Fry	fry_X_cycle
Travis Ganong	travisganong
Jonathan Garcia	JAGarcia23
Nick Goepper	NickGoepper
Gracie Gold	GraceEGold
Arielle Gold	arielletgold
Taylor Gold	Taylor_Gold
Jared Goldberg	Jared_Goldberg
Brian Gregg	xcSkiLifeBG
Jamie Greubel	JamieGreubel
Preston Griffall	prestongriffall
Chas Guldemond	chasguldemond
Faye Gulini	FayeGulini
Kelly Gunther	KellyAGunther
Simi Hamilton	simihamilton
Erin Hamlin	erinhamlin
Kate Hansen	k8ertotz
Brian Hansen	BrianTHansen
Sarah Hendrickson	Schendrickson
Keri Herman	KeriHerman
Jacqueline Hernandez	jackiepatty_
Steve Holcomb	StevenHolcomb
Nate Holland	N8Holland
Jeff Isaacson	LaZylkE_14
Trevor Jacob	trevorjacob93
Lindsey Jacobellis	LindsJacobellis
Jessika Jensen	jessika_jenson
Jessica Jerome	JessicaJerome
Tim Jitloff	T_Jit
Anders Johnson	flyingaj
Lolo Jones	lolojones
Patrick Kane	88PKane
Nolan Kasper	Nolankasper
Hannah Kearney	HK_ski
Aidan Kelly	aidankellyusa
Gus Kenworthy	guskenworthy
Ryan Kesler	Ryan_Kesler
Amanda Kessel	AmandaKessel8
Phil Kessel	PKessel81
Heidi Kloser	heidikloser
Hilary Knight	Hilary_Knight
Sage Kotsenburg	sagekotsenburg
Julia Krass	juliakrass15
Jonathan Kuck	JDKuck
Maria Lamb	MariaTLamb
Jocelyne Lamoureux	JocelyneUSA17
Monique Lamoureux	moniquelam7
John Landsteiner	jlandsteiner
Steve Langton	StevenLangton
Emery Lehman	Mry_the_Eman
Ted Ligety	tedligety
Devin Logan	dlogan
Jordan Malone	j2k111
Julia Mancuso	JuliaMancuso
Joey Mantia	JRMantia
Gigi Marvin	GigiMarvin
Chris Mazdzer	mazdzer
Debbie McCormick	Deb_McCormick
Ryan McDonagh	RMcDonagh27
Brianne McLaughlin-Bittle	BrianneMcL
Heather McPhie	heathermcphie
Patrick Meek	PatJMeek
Elana Meyers	eamslider24
Ryan Miller	RyanMiller3039
Bode Miller	MillerBode
Matt Mortensen	MattMortensen_
Andy Newell	AndyNewellskier
Leif Nordgren	lcnordgren
Steven Nyman	BelieveinSteven
Justin Olsen	JustinbOlsen
T.J. Oshie	OSH74
Eliza Outtrim	ElizaOuttrim
Michelle Picard	shellfish20
Noelle Pikus-Pace	noellepikuspace
Allison Pottinger	APottinger
Josephine Pucci	josephinepucci
Jonathan Quick	jonathanquick32
Johnny Quinn	JohnnyQuinnUSA
Kikkan Randall	Kikkanimal
Justin Reiter	justin-reiter
Heather Richardson	HLynnRichardson
Anna Ringsred	annaringsred
Dallas Robinson	DRobUSA
Jilleanne Rookard	JMRookard
Laurenne Ross	lalalalaurenne
Ida Sargent	idasargent
Molly Schaus	schaus729
Anne Schleper	_aschlep
Jessica Schultz	Jess_Curls
Emily Scott	EmScott89
Kevin Shattenkirk	shattdeuces
Alex Shibutani	AlexShibutani
Maia Shibutani	MaiaShibutani
Mikaela Shiffrin	MikaelaShiffrin
Simon Shnapir	SimonShnapir
Karly Shorr	KarlyShorr
John Shuster	shoostie2010
Brita Sigourney	britasig
Jessica Smith	TheJessicaSmith
Kelli Stack	kstack16
Paul Stastny	paulywalnuts26
Lee Stecklein	LeeSteck2
Derek Stepan	DerekStepan21
Liz Stephen	lizstephen
Resi Stiegler	resistiegler
Sara Studebaker	SaraStudebaker
Marco Sullivan	marcOsullivan
Ryan Suter	rsuter20
Ann Swisshelm	curlannie
John Teller	john_teller
Jayson Terdiman	jterdimanUSA
Hannah Teter	hannahteter
Sugar Todd	SugarMotion
Curt Tomasevicz	ctomasevicz
Kyle Tress	KyleTress
Katie Uhlaender	katieU11
James van Riemsdyk	JVReemer21
Lindsey Van	lindseyvan
Angeli VanLaanen	Angeli_V
Jessie Vetter	Vetter31
Maggie Voisin	maggie_voisin
Ashley Wagner	AshWagner2010
Ty Walker	ty_walker_
Andrew Weibrecht	a_weibrecht
Tucker West	TuckerWest1
Blake Wheeler	BiggieFunke
Shaun White	Shaun_White
Charlie White	CharlieAWhite
Mitch Whitmore	whitmoreUSA
Jacqueline Wiles	JankyLilJ
Lauryn Williams	lauryncwilliams
Bradley Wilson	wilsFreestyle
David Wise	mrDavidWise
Torin Yater-Wallace	TorinWallace
Jared Zezel	JaredZezel04
Felicia Zhang	felicia_zhang
